start 19 0 2
light 0.5

# LOWER ARENA
  t 0 0 -2
  r 0 0 0
  d Main Arena - Floor
  000000000000000000000000000000000000000000000000000000000000000000000000000000000000000000000000000000
  000000000000000000000000000000000000000000000000000000000000000000000000000000000000000000000000000000
  000000000000000000000000000000000000000000000000000000000000000000000000000000000000000000000000000000
  000000000000000000000000000000000000000000000000000000000000000000000000000000000000000000000000000000
  000000000000000000000000000000000000000000000000000000000000000000000000000000000000000000000000000000
  000000000000000000000000000000000000000000000000000000000000000000000000000000000000000000000000000000
  000000000000000000000000000000000000000000000000000000000000000000000000000000000000000000000000000000
  000000000000000000000000000000000000000000000000000000000000000000000000000000000000000000000000000000
  000000000000000000000000000000000000000000000000000000000000000000000000000000000000000000000000000000
  000000000000000000000000000000000000000000000000000000000000000000000000000000000000000000000000000000
  000000000000000000000000000000000000000000000000000000000000000000000000000000000000000000000000000000
  000000000000000000000000000000000000000000000000000000000000000000000000000000000000000000000000000000
  000000000000000000000000000000000000000000000000000000000000000000000000000000000000000000000000000000
  000000000000000000000000000000000000000000000000000000000000000000000000000000000000000000000000000000
  000000000000000000000000000000000000000000000000000000000000000000000000000000000000000000000000000000
  000000000000000000000000000000000000000000000000000000000000000000000000000000000000000000000000000000
  000000000000000000000000000000000000000000000000000000000000000000000000000000000000000000000000000000
  000000000000000000000000000000000000000000000000000000000000000000000000000000000000000000000000000000
  000000000000000000000000000000000000000000000000000000000000000000000000000000000000000000000000000000
  000000000000000000000000000000000000000000000000000000000000000000000000000000000000000000000000000000

  t 0 1 -1
  r 0 90 90
  d Main Arena -  Back Wall
  00000000000000000000
  00000000000000000000
  00000000000000000000
  00000000000000000000
  00000000000000000000
  00000000000000000000
  00000000000000000000
  00000000000000000000
  00000000000000000000
  00000000000000000000
  00000000000000000000
  00000000000000000000
  00000000000000000000
  00000000000000000000
  00000000000000000000
  00000000000000000000
  00000000000000000000
  00000000000000000000
  00000000000000000000
  00000000000000000000

  t 54 -0.5 140
  r 0 -90 90
  d Main Arena -  Front Wall
  000000000000000000000000000000000000
  000000000000000000000000000000000000
  000000000000000000000000000000000000
  000000000000000000000000000000000000
  000000000000000000000000000000000000
  000000000000000000000000000000000000
  000000000000000000000000000000000000
  000000000000000000000000000000000000
  000000000000000000000000000000000000
  000000000000000000000000000000000000
  000000000000000000000000000000000000
  000000000000000000000000000000000000
  000000000000000000000000000000000000
  000000000000000000000000000000000000
  000000000000000000000000000000000000
  000000000000000000000000000000000000
  000000000000000000000000000000000000
  000000000000000000000000000000000000
  000000000000000000000000000000000000
  000000000000000000000000000000000000

  t 40 -0.5 0
  r 0 0 90
  d Main Arena - Left Wall
  0000000000000000000000000000000000000000000000000000000000000000000000000000000000000000000000000000
  0000000000000000000000000000000000000000000000000000000000000000000000000000000000000000000000000000
  0000000000000000000000000000000000000000000000000000000000000000000000000000000000000000000000000000
  0000000000000000000000000000000000000000000000000000000000000000000000000000000000000000000000000000
  0000000000000000000000000000000000000000000000000000000000000000000000000000000000000000000000000000
  0000000000000000000000000000000000000000000000000000000000000000000000000000000000000000000000000000

  t 0 13 0
  r 0 0 -90
  d Main Arena - Right Wall
  0000000000000000000000000000000000000000000000000000000000000000000000000000000000000000000000000000
  0000000000000000000000000000000000000000000000000000000000000000000000000000000000000000000000000000
  0000000000000000000000000000000000000000000000000000000000000000000000000000000000000000000000000000
  0000000000000000000000000000000000000000000000000000000000000000000000000000000000000000000000000000
  0000000000000000000000000000000000000000000000000000000000000000000000000000000000000000000000000000
  0000000000000000000000000000000000000000000000000000000000000000000000000000000000000000000000000000

# LEFT SIDE
  t 39.2 10.5 0
  r 0 0 15
  d Left Side - Incline
  00000000000000000000000000000000000000000000000000000000000000000000000000000000000-----------------
  00000000000000000000000000000000000000000000000000000000000000000000000000000000000-----------------
  00000000000000000000000000000000000000000000000000000000000000000000000000000000000-----------------
  00000000000000000000000000000000000000000000000000000000000000000000000000000000000-----------------
  00000000000000000000000000000000000000000000000000000000000000000000000000000000000-----------------
  00000000000000000000000000000000000000000000000000000000000000000000000000000000000-----------------
  00000000000000000000000000000000000000000000000000000000000000000000000000000000000-----------------
  00000000000000000000000000000000000000000000000000000000000000000000000000000000000-----------------

  t 55.4 15.6 0
  r 0 0 90
  d Left Side - Outer wall
  -------0000000000000000000000000000000000000000000000000000000000000000000000000000-----------------
  -------0000000000000000000000000000000000000000000000000000000000000000000000000000-----------------
  -------0000000000000000000000000000000000000000000000000000000000000000000000000000-----------------
  -------0000000000000000000000000000000000000000000000000000000000000000000000000000-----------------
  -------0000000000000000000000000000000000000000000000000000000000000000000000000000-----------------

  t 39.6 9.6 -0.6
  r 0 45 90
  d Left Side - Start Wall
  000000000000000
  000000000000000
  000000000000000
  000000000000000
  000000000000000
  000000000000000
  000000000000000
  000000000000000
  000000000000000
  000000000000000
  000000000000000
  000000000000000
  000000000000000


# RIGHT SIDE
  t -14.7 16.1 0
  r 0 0 -15
  d Right Side - Incline
  00000000000000000000000000000000000000000000000000000000000000000000000000000000000-----------------
  00000000000000000000000000000000000000000000000000000000000000000000000000000000000-----------------
  00000000000000000000000000000000000000000000000000000000000000000000000000000000000-----------------
  00000000000000000000000000000000000000000000000000000000000000000000000000000000000-----------------
  00000000000000000000000000000000000000000000000000000000000000000000000000000000000-----------------
  00000000000000000000000000000000000000000000000000000000000000000000000000000000000-----------------
  00000000000000000000000000000000000000000000000000000000000000000000000000000000000-----------------
  00000000000000000000000000000000000000000000000000000000000000000000000000000000000-----------------

  t -9.7 25.5 -5
  r 0 0 -90
  d Right Side - Outer wall
  -------0000000000000000000000000000000000000000000000000000000000000000000000000000-----------------
  -------0000000000000000000000000000000000000000000000000000000000000000000000000000-----------------
  -------0000000000000000000000000000000000000000000000000000000000000000000000000000-----------------
  -------0000000000000000000000000000000000000000000000000000000000000000000000000000-----------------
  -------0000000000000000000000000000000000000000000000000000000000000000000000000000-----------------

  t -09.6 9.6 9.3
  r 0 135 90
  d Right Side - Start Wall
  000000000000000
  000000000000000
  000000000000000
  000000000000000
  000000000000000
  000000000000000
  000000000000000
  000000000000000
  000000000000000
  000000000000000
  000000000000000
  000000000000000
  000000000000000


# CEILING
  t 55.1 26.4 0
  r 0 0 150
  d Ceiling - Left Side
  0000000000000000000000000000000000000000000000000000000000000000000000000000000000000000000000000000
  0000000000000000000000000000000000000000000000000000000000000000000000000000000000000000000000000000
  0000000000000000000000000000000000000000000000000000000000000000000000000000000000000000000000000000
  0000000000000000000000000000000000000000000000000000000000000000000000000000000000000000000000000000
  0000000000000000000000000000000000000000000000000000000000000000000000000000000000000000000000000000
  0000000000000000000000000000000000000000000000000000000000000000000000000000000000000000000000000000
  0000000000000000000000000000000000000000000000000000000000000000000000000000000000000000000000000000
  0000000000000000000000000000000000000000000000000000000000000000000000000000000000000000000000000000
  0000000000000000000000000000000000000000000000000000000000000000000000000000000000000000000000000000
  0000000000000000000000000000000000000000000000000000000000000000000000000000000000000000000000000000
  0000000000000000000000000000000000000000000000000000000000000000000000000000000000000000000000000000
  0000000000000000000000000000000000000000000000000000000000000000000000000000000000000000000000000000
  0000000000000000000000000000000000000000000000000000000000000000000000000000000000000000000000000000
  0000000000000000000000000000000000000000000000000000000000000000000000000000000000000000000000000000

  t 30.5 40.4 0
  r 0 0 180
  d Ceiling - Top
  0000000000000000000000000000000000000000000000000000000000000000000000000000000000000000000000000000
  0000000000000000000000000000000000000000000000000000000000000000000000000000000000000000000000000000
  0000000000000000000000000000000000000000000000000000000000000000000000000000000000000000000000000000
  0000000000000000000000000000000000000000000000000000000000000000000000000000000000000000000000000000
  0000000000000000000000000000000000000000000000000000000000000000000000000000000000000000000000000000
  0000000000000000000000000000000000000000000000000000000000000000000000000000000000000000000000000000
  0000000000000000000000000000000000000000000000000000000000000000000000000000000000000000000000000000
  0000000000000000000000000000000000000000000000000000000000000000000000000000000000000000000000000000
  0000000000000000000000000000000000000000000000000000000000000000000000000000000000000000000000000000
  0000000000000000000000000000000000000000000000000000000000000000000000000000000000000000000000000000
  0000000000000000000000000000000000000000000000000000000000000000000000000000000000000000000000000000
  0000000000000000000000000000000000000000000000000000000000000000000000000000000000000000000000000000

  t 15.1 40.3 0
  r 0 0 -150
  d Ceiling - Right Side
  0000000000000000000000000000000000000000000000000000000000000000000000000000000000000000000000000000
  0000000000000000000000000000000000000000000000000000000000000000000000000000000000000000000000000000
  0000000000000000000000000000000000000000000000000000000000000000000000000000000000000000000000000000
  0000000000000000000000000000000000000000000000000000000000000000000000000000000000000000000000000000
  0000000000000000000000000000000000000000000000000000000000000000000000000000000000000000000000000000
  0000000000000000000000000000000000000000000000000000000000000000000000000000000000000000000000000000
  0000000000000000000000000000000000000000000000000000000000000000000000000000000000000000000000000000
  0000000000000000000000000000000000000000000000000000000000000000000000000000000000000000000000000000
  0000000000000000000000000000000000000000000000000000000000000000000000000000000000000000000000000000
  0000000000000000000000000000000000000000000000000000000000000000000000000000000000000000000000000000
  0000000000000000000000000000000000000000000000000000000000000000000000000000000000000000000000000000
  0000000000000000000000000000000000000000000000000000000000000000000000000000000000000000000000000000
  0000000000000000000000000000000000000000000000000000000000000000000000000000000000000000000000000000
  0000000000000000000000000000000000000000000000000000000000000000000000000000000000000000000000000000
