start 19 0 2

# LOWER ARENA
  t 0 0 0
  r 0 0 0
  d Main Arena - Floor
  0000000000000000000000000000000000000000000000000000000000000000000000000000000000000000000000000000
  0000000000000000000000000000000000000000000000000000000000000000000000000000000000000000000000000000
  0000000000000000000000000000000000000000000000000000000000000000000000000000000000000000000000000000
  0000000000000000000000000000000000000000000000000000000000000000000000000000000000000000000000000000
  0000000000000000000000000000000000000000000000000000000000000000000000000000000000000000000000000000
  0000000000000000000000000000000000000000000000000000000000000000000000000000000000000000000000000000
  0000000000000000000000000000000000000000000000000000000000000000000000000000000000000000000000000000
  0000000000000000000000000000000000000000000000000000000000000000000000000000000000000000000000000000
  0000000000000000000000000000000000000000000000000000000000000000000000000000000000000000000000000000
  0000000000000000000000000000000000000000000000000000000000000000000000000000000000000000000000000000
  0000000000000000000000000000000000000000000000000000000000000000000000000000000000000000000000000000
  0000000000000000000000000000000000000000000000000000000000000000000000000000000000000000000000000000
  0000000000000000000000000000000000000000000000000000000000000000000000000000000000000000000000000000
  0000000000000000000000000000000000000000000000000000000000000000000000000000000000000000000000000000
  0000000000000000000000000000000000000000000000000000000000000000000000000000000000000000000000000000
  0000000000000000000000000000000000000000000000000000000000000000000000000000000000000000000000000000
  0000000000000000000000000000000000000000000000000000000000000000000000000000000000000000000000000000
  0000000000000000000000000000000000000000000000000000000000000000000000000000000000000000000000000000
  0000000000000000000000000000000000000000000000000000000000000000000000000000000000000000000000000000
  0000000000000000000000000000000000000000000000000000000000000000000000000000000000000000000000000000

  t 40 -0.5 0
  r 0 0 90
  d Main Arena - Left Wall
  0000000000000000000000000000000000000000000000000000000000000000000000000000000000000000000000000000
  0000000000000000000000000000000000000000000000000000000000000000000000000000000000000000000000000000
  0000000000000000000000000000000000000000000000000000000000000000000000000000000000000000000000000000
  0000000000000000000000000000000000000000000000000000000000000000000000000000000000000000000000000000
  0000000000000000000000000000000000000000000000000000000000000000000000000000000000000000000000000000
  0000000000000000000000000000000000000000000000000000000000000000000000000000000000000000000000000000

  t 0 13 0
  r 0 0 -90
  d Main Arena - Right Wall
  0000000000000000000000000000000000000000000000000000000000000000000000000000000000000000000000000000
  0000000000000000000000000000000000000000000000000000000000000000000000000000000000000000000000000000
  0000000000000000000000000000000000000000000000000000000000000000000000000000000000000000000000000000
  0000000000000000000000000000000000000000000000000000000000000000000000000000000000000000000000000000
  0000000000000000000000000000000000000000000000000000000000000000000000000000000000000000000000000000
  0000000000000000000000000000000000000000000000000000000000000000000000000000000000000000000000000000

# LEFT SIDE
  t 39.2 10.5 0
  r 0 0 15
  d Left Side - Incline
  00000000000000000000000000000000000000000000000000000000000000000000000000000000000-----------------
  00000000000000000000000000000000000000000000000000000000000000000000000000000000000-----------------
  00000000000000000000000000000000000000000000000000000000000000000000000000000000000-----------------
  00000000000000000000000000000000000000000000000000000000000000000000000000000000000-----------------
  00000000000000000000000000000000000000000000000000000000000000000000000000000000000-----------------
  00000000000000000000000000000000000000000000000000000000000000000000000000000000000-----------------
  00000000000000000000000000000000000000000000000000000000000000000000000000000000000-----------------
  00000000000000000000000000000000000000000000000000000000000000000000000000000000000-----------------

  t 55.4 15.6 0
  r 0 0 90
  d Left Side - Outer wall
  -------0000000000000000000000000000000000000000000000000000000000000000000000000000-----------------
  -------0000000000000000000000000000000000000000000000000000000000000000000000000000-----------------
  -------0000000000000000000000000000000000000000000000000000000000000000000000000000-----------------
  -------0000000000000000000000000000000000000000000000000000000000000000000000000000-----------------
  -------0000000000000000000000000000000000000000000000000000000000000000000000000000-----------------

  t 39.6 9.6 -0.6
  r 0 45 90
  d Left Side - Start Wall
  000000000000000
  000000000000000
  000000000000000
  000000000000000
  000000000000000
  000000000000000
  000000000000000
  000000000000000
  000000000000000
  000000000000000
  000000000000000
  000000000000000
  000000000000000


# CEILING
  t 55.1 26.4 0
  r 0 0 150
  d Ceiling - Left Side
  0000000000000000000000000000000000000000000000000000000000000000000000000000000000000000000000000000
  0000000000000000000000000000000000000000000000000000000000000000000000000000000000000000000000000000
  0000000000000000000000000000000000000000000000000000000000000000000000000000000000000000000000000000
  0000000000000000000000000000000000000000000000000000000000000000000000000000000000000000000000000000
  0000000000000000000000000000000000000000000000000000000000000000000000000000000000000000000000000000
  0000000000000000000000000000000000000000000000000000000000000000000000000000000000000000000000000000
  0000000000000000000000000000000000000000000000000000000000000000000000000000000000000000000000000000
  0000000000000000000000000000000000000000000000000000000000000000000000000000000000000000000000000000
  0000000000000000000000000000000000000000000000000000000000000000000000000000000000000000000000000000
  0000000000000000000000000000000000000000000000000000000000000000000000000000000000000000000000000000
  0000000000000000000000000000000000000000000000000000000000000000000000000000000000000000000000000000
  0000000000000000000000000000000000000000000000000000000000000000000000000000000000000000000000000000
  0000000000000000000000000000000000000000000000000000000000000000000000000000000000000000000000000000
  0000000000000000000000000000000000000000000000000000000000000000000000000000000000000000000000000000
